11000000000000000000
10000000000000000000
11000000000000000000
10000000000000000000
11000000000000000000
10000000000000000000
11000000000000000000
10000000000000000000
11010101010101010101
11111111111111111111