0
0
0
1
00000000000000000000
01000000000000000010
00100000000000000100
00010000000000001000
00000000000000000000
00000000000000000000
00010000000000001000
00100000000000000100
01000000000000000010
00000000000000000000