1
2
3
00000000000000000001
00000001000000000001
00000000000000000001
00000000000000000001
00000000100000000001
00000000000000000001
00000000000000000001
00000000010000000001
00000000000000000001
00000000000000000001